type octile
height 49
width 49
map
TTTTTTTTTTTTTTTTTTTTTTTTTTTTTTTTTTTTTTTTTTTTTTTTT
T...............................................T
T...............................................T
T...............................................T
T...............................................T
T...............................................T
T...............................................T
T..............TTT.............TTT..............T
T.............TTTTT...........TTTTT.............T
T.............TTTTT...........TTTTT.............T
T..............TTT.............TTT..............T
T...............................................T
T...............................................T
T...............................................T
T...............................................T
T...............................................T
T...............................................T
T....................TTT........................T
T...................TTTTT.......................T
T...................TTTTT.......................T
T....................TTT........................T
T...............................................T
T........TTT......................TTT...........T
T.......TTTTT....................TTTTT..........T
T.......TTTTT....................TTTTT..........T
T........TTT......................TTT...........T
T...............................................T
T.......................................TTTT....T
T......................................TTTTTT...T
T....................TTT...............TTTTTT...T
T...................TTTTT................TT.....T
T...................TTTTT.......................T
T....................TTT........................T
T...............................................T
T...............................................T
T...............................................T
T...............................................T
T........TTT......................TTT...........T
T.......TTTTT....................TTTTT..........T
T.......TTTTT....................TTTTT..........T
T........TTT......................TTT...........T
T...............................................T
T...............................................T
T...............................................T
T...............................................T
T...............................................T
T...............................................T
T...............................................T
TTTTTTTTTTTTTTTTTTTTTTTTTTTTTTTTTTTTTTTTTTTTTTTTT
