type octile
height 10
width 10
map
TTTTTTTTTT
T........T
T........T
T........T
T........T
T........T
T........T
T........T
T........T
TTTTTTTTTT
