type octile
height 15
width 15
map
TTTTTTTTTTTTTTT
T.............T
T.............T
T.............T
T.............T
T.............T
T....TTTTT....T
T....TTTTT....T
T.............T
T.............T
T.............T
T.............T
T.............T
T.............T
TTTTTTTTTTTTTTT
